a	a
ad	ad
an	an
b	b
c	c
cc	cc
d	d
e	e
f	f
g	g
gacn	gacn
gjtgj	gjtgj
gms	gms
gwz	gwz
h	h
happ	happ
k	k
l	l
m	m
Mg	Mg
mq	mq
n	n
nr	nr
ns	ns
nt	nt
nz	nz
o	o
p	p
q	q
qt	qt
#qv	qv
r	r
Rg	Rg
s	s
t	t
tg	tg
u	u
v	v
vn	vn
y	y
z	z
